C 0, 0,     0

NO  texture/mandatory/north_mandatory.xpm
SO  texture/mandatory/south_mandatory.xpm 
WE  texture/mandatory/west_mandatory.xpm
EA  texture/mandatory/east_mandatory.xpm



F 192,     192,    192


111111111111111111111111
10000000000000000000S001
100000000000000000000001
100000000000000000000001
101010101010101010101011
110101000101101101010101
100000100000000001000001
100001000000000000100001
100001000000000000100001
100000100000000001000001
100000011000000110000001
100000000000000000000001
111111111111111111111111

