F 232,172,144

NO   texture/north_texture.xpm
SO   texture/south_texture.xpm
WE   texture/west_texture.xpm
EA  texture/east_texture.xpm

D1 texture/scifidoor.xpm


C 18, 9, 9




11111111111111111111111111
10000000001100011000000001
11000000011100000000000001
10010000000000000000000001
111111111011000001110000011111111
100000000000000001111101111111111   
1111D111111111D1111111D1111111111           
111100000000000000000000000001111
11111111111111D111111111111111111          
1111111111111100000000111      
           11100000111111
           10000000010111           
           11100000000111
           110000N0010111    
1111111111111000000000111111
11000000110000000000000110011
10000000000000000000000000001
10000000000000000000000000001
11000001D10001011110001110001
1111011101100101 110011110001
1111111101111111 111111111111
11111111011111
10000000000011
11110000001111
111111D1111111
11110000011111
11100000001111
110001D1000111
10001000100011
10010000010001
10100000001001
10010000010001
10001000100001
100011D1100001
11D1100011D111
10000000000011
11111111111111