NO   texture/north_texture.xpm
SO   texture/south_texture.xpm
WE   texture/west_texture.xpm
EA  texture/east_texture.xpm


D1 texture/scifidoor.xpm


C 0, 0,         0  
F 173,216,230


11111111111111111111111111111111
1N000000000000000000000000000001
10000000000000000000000000000001
10000000000000000000000000000001
10000000000000000000000000000001
10000000000000000000000000000001
10000000000000000000000000000001
10000000000000000000000000000001
10000000000000000000000000000001
10000000000000100100000000000001
10000000000001000010000000000001
10000000000010000001000000000001
10000000000100000000100000000001
10000000001000000000010000000001
10000000010000000000001000000001
10000000010000000000001000000001
10000000001000000000010000000001
10000000000100000000100000000001
10000000000010000001000000000001
10000000000001000010000000000001
10000000000000100100000000000001
10000000000000000000000000000001
10000000000000000000000000000001
10000000000000000000000000000001
10000000000000000000000000000001
10000000000000000000000000000001
10000000000000000000000000000001
10000000000000000000000000000001
10000000000000000000000000000001
11111111111111111111111111111111