NO   texture/north_texture.xpm
SO   texture/south_texture.xpm
WE   texture/west_texture.xpm
EA  texture/east_texture.xpm


D1 texture/scifidoor.xpm


F 173,216,230
C 0, 0, 0    


11111111111111
1W000000000011
11110000001111
111111D1111111
11110000011111
11100000001111
110001D1000111
10001000100011
10010000010001
10100000001001
10010000010001
10001000100001
100011D1100001
11D1100011D111
10000000000011
11111111111111